1111111111111111111111111111111111
10E111111000111C11110C111111111101
101001011010000010100100000001C101
1010010010101010001001011111010101
1P0000000C10C1111000000000C10000C1
1111111111111111111111111111111111