11111111111111111111111
1000C000000000000000001
1000C000000000000000001
1000C000000000000000001
1000C000000000000000001
10111111111111111111101
10111111111111111110001
10111111111111111110111
1P1111E00000000000000C1
11111111111111111111111