1111111111111111111111111111111111
1000P000CCCCCCCCCCCCCCCCCCCCCCCCC1
11111111111111111111111111111111C1
1CCCCCCCCCCCCCCCCCCCCCCCCCCCCCCCC1
1C11111111111111111111111111111111
1CCCCCCCCCCCCCCCCCCCCCCCCCCCCCCCC1
11111111111111111111111111111111C1
1CCCCCCCCCCCCCCCCCCCCCCCCCCCCCCCC1
1C11111111111111111111111111111111
1CCCCCCCCCCCCCCCCCCCCCCCCCCCCCCCC1
11111111111111111111111111111111C1
1CCCCCCCCCCCCCCCCCCCCCCCCCCCCCCCC1
1C11111111111111111111111111111111
1CCCCCCCCCCCCCCCCCCCCCCCCCCCCCCCC1
11111111111111011111111111111111C1
1E0000000000CCCCCCCCCCCCCCCCCCCCC1
1111111111111111111111111111111111