1111111111111111111111111111111111
10PCCCCCCCCCCCCCCCCCCCCCCCCCCCCCC1
11111111111111111111111111111111C1
1CCCCCCCCCCCCCCCCCCCCCCCCCCCCCCCC1
1C11111111111111111111111111111111
1CCCCCCCCCCCCCCCCCCCCCCCCCCCCCCCC1
11111111111111111111111111111111C1
1CCCCCCCCCCCCCCCCCCCCCCCCCCCCCCCC1
1C11111111111111111111111111111111
1CCCCCCCCCCCCCCCCCCCCCCCCCCCCCCCC1
11111111111111111111111111111111C1
1CCCCCCCCCCCCCCCCCCCCCCCCCCCCCCCC1
1C11111111111111111111111111111111
1CCCCCCCCCCCCCCCCCCCCCCCCCCCCCCCC1
11111111111111111111111111111111C1
1ECCCCCCCCCCCCCCCCCCCCCCCCCCCCCCC1
1111111111111111111111111111111111