11111111111111
1C000000E10001
10010P00010001
1C0C0000110001
11111111111111