111111111111111111
10C1C00000000000C1
10C1000000000000C1
10C1000001111000C1
101001111000000011
1P0011E000000000C1
111111111111111111