1111111111111
10C1C000000C1
10C10000000C1
10C10000030C1
1010011111001
1P0011E0000C1
1111111111111