1111111111111111111111111111111111111111111
10P00000000000C0000000000000000000000000111
100000C000000000000000000000000000000000111
1000000000000000000000000000000000000000111
1000000000000000000000000000000000000000111
1000000000000000000000000000000000000000111
1111111111111111111111111111111111111111111
1111111111111111111111111111111111111111111
1111111111111111111111111111111111111111111
1111111111111111111111111111111111111111111
1111111111111111111111111111111111111111111
1111111111111111111111111111111111111111111
1111111111111111111111111111111111111111111
1111111111111111111111111111111111111111111
1111111111111111111111111111111111111111111
10000000000000C000000E000000000000000000111
1111111111111111111111111111111111111111111
1111111111111111111111111111111111111111111
1111111111111111111111111111111111111111111
