11111111111111111111111111111
1CCCCCCCCCCCCCCCCCCCCCCCCCCC1
1C1111111111111111111111111C1
1C1111CCCCCCCCCCE1111111111C1
1C1111C11111111111111111111C1
1P1111CCCCCCCCCCCCCCCCCCCCCC1
11111111111111111111111111111