111111111111111111
1CCCCCCCCCCCCCCCC1
1C11111111111111C1
1C11ECC111111111C1
1C1111C111111111C1
1P1111CCCCCCCCCCC1
111111111111111111