111111111111111111
11C0C00000000000C1
11C0000000000000C1
11C00000C1111000C1
1110011111000000C1
1P0011E000000000C1
111111111111111111