1111111
111C111
111C111
111C111
111C111
111C111
111C111
111C111
1CECC11
1CPCC11
1CCC0C1
1111111