1111111111111111111111111111111111111111111111111111111111111111111111111
1111111111111111111111111111111111111111111111111111111111111111111111111
11111111111000000000000000000000000P1111111111111111111111111111111111111
1111111111101111111111111111111111111111111111111111111111111111111111111
11111CCCCCCC11CCCCCCCC000C111111111CCCCCCCC11CC11111C11CCCCCCCC1111111111
11111C11111111C111111C111C111111111C111111C11CCC1111C11C11111111111111111
11111C11111111C111111C111C111111111C111111C11C1CC111C11C11111111111111111
11111CCCCCCC11C111111C111C111111111C111111C11C11CC11C11C11CCCCC1111111111
11111111111C11C111111C111C111111111C111111C11C111CC1C11C111111C1111111111
11111111111C11C111111C111C111111111C111111C11C1111CCC11C111111C1111111111
11111CCCCCCC11CCCCCCCC111CCCCCCCC11CCCCCCCC11C111111C11CCCCCCCC1111111111
1111111101111111101111111111111101111110111110111111011011111111111111111
11111111000000000000000000000000000000000000000000000000000000000000000E1
1111111111111111111111111111111111111111111111111111111111111111111111111