1111111111111111111111111111111111111111111111111111111111111111111111111
1111111111111111111111111111111111111111111111111111111111111111111111111
11000000000000000000000000000000000P1111111111111111111111111111111111111
1101111111111111111111111111111111111111111111111111111111111111111111111
11011CCCCCCC11CCCCCCCC111C111111111CCCCCCCC11CC11111C11CCCCCCCC1111111111
11011C11111111C111111C111C111111111C111111C11CCC1111C11C11111111111111111
11011C11111111C111111C111C111111111C111111C11C1CC111C11C11111111111111111
11011CCCCCCC11C111111C111C111111111C111111C11C11CC11C11C11ECCCC1111111111
11011111111C11C111111C111C111111111C111111C11C111CC1C11C111111C1111111111
11011111111C11C111111C111C111111111C111111C11C1111CCC11C111111C1111111111
11011CCCCCCC11CCCCCCCC111CCCCCCCC11CCCCCCCC11C111111C11CCCCCCCC1111111111
1101111101111111101111111111011111111110111110111111011011111111111111111
11000000000000000000000000000M0000000000000000111111000011111111111111111
1111111111111111111111111111111111111111111111111111111111111111111111111