111111111111111111
1P00C0000C000C00C1
111111111111111101
1C0C00000C0000C101
101111111111110101
101E00C00000C10C01
101111111111011111
1C00C0000C00011111
111111111111111111