111111111111111111
1P0000000000000001
111111111111111101
100000000000000101
101111111111110101
101EC0000000010001
101111111111011111
1000C0000000011111
111111111111111111