1111111111111111111111111111111111
1P0000000000C0000C0000C000000000C1
1011111111111111111111111111111101
1E11C000000000000C0000000C000000C1
1111011111111111111111111111111111
1C0000C000000C0000000C0000C00000C1
1011111111111111111111111111111101
10111111C00000C11C00000C11C00C00C1
1011111101111101101111101101111111
1C000000C11111C00C11111C00C1111111
1111111111111111111111111111111111