1111111111111111111111111111111111111111111111111111111111111111111111111
1CCCCCCCCCCCCCCCCCCCCCCCCCCCCCCCCCCCCCCCCCCCCCCCCCCCCCCCCCCCCCCCCCCCCCCC1
1CCCCCCCCCCCCCCCCCCCCCCCCCCCCCCCCCCPCCCCCCCCCCCCCCCCCCCCCCCCCCCCCCCCCCCC1
1CCCCCCCCCCCCCCCCCCCCCCCCCCCCCCCCCCCCCCCCCCCCCCCCCCCCCCCCCCCCCCCCCCCCCCC1
1CCCC1111111CC11111111CCCC1CCCCCCCCC11111111CC11CCCCC1CC11111111CCCCCCCC1
1CCCC1CCCCCCCC1CCCCCC1CCCC1CCCCCCCCC1CCCCCC1CC1C1CCCC1CC1CCCCCCCCCCCCCCC1
1CCCC1CCCCCCCC1CCCCCC1CCCC1CCCCCCCCC1CCCCCC1CC1CC1CCC1CC1CCCCCCCCCCCCCCC1
1CCCC1111111CC1CCCCCC1CCCC1CCCCCCCCC1CCCCCC1CC1CCC1CC1CC1CCC1111CCCCCCCC1
1CCCCCCCCCC1CC1CCCCCC1CCCC1CCCCCCCCC1CCCCCC1CC1CCCC1C1CC1CCCCCC1CCCCCCCC1
1CCCCCCCCCC1CC1CCCCCC1CCCC1CCCCCCCCC1CCCCCC1CC1CCCCC11CC1CCCCCC1CCCCCCCC1
1CCCC1111111CC11111111CCCC11111111CC11111111CC1CCCCCC1CC11111111CCCCCCCC1
1CCCCCCCCCCCCCCCCCCCCCCCCCCCCCCCCCCCCCCCCCCCCCCCCCCCCCCCCCCCCCCCCCCCCCCC1
1CCCCCCCCCCCCCCCCCCCCCCCCCCCCCCCCCCECCCCCCCCCCCCCCCCCCCCCCCCCCCCCCCCCCCC1
1111111111111111111111111111111111111111111111111111111111111111111111111