1111111111111111111111111111111111111111111111111111111111
1CCCCCCCCCCCCCCCCCCCCCCCCCCCCCCCCCCCCCCCCCCCCCCCCCCCCCCCP1
1C1111111C1C111111C1C1111111C1C111111C111111111C11111111C1
1C1CCCCCCC1CCCCCC1C1C1111111C1CCCCCC1C1CCCCCCC1C1CCCCCCCC1
1C1CCCCCCC1C1111C1C1C1111111C1C1111C1C1C11111C1C1CCCCCCCC1
1C1111111C1C1111C1C1C1111111C1C1111C1C1C11111C1C1CCC1111C1
1CCCCCCC1C1C1111C1C1C1111111C1C1111C1C1C11111C1C1CCCCCC1C1
1CCCCCCC1C1CCCCCC1C1CCCCCCCCC1CCCCCC1C1C11111C1C1CCCCCC1C1
1C1111111C11111111C111111111C11111111C1C11E11C1C11111111C1
1CCCCCCCCCCCCCCCCCCCCCCCCCCCCCCCCCCCCCCCCCCCCCCCCCCCCCCCC1
1111111111111111111111111111111111111111111111111111111111