11111111111111111111111111111111111
100000000000C0000000000000000000PE1
11111111111111111111111111111111111