1111111111111111111111111111111111
1P000000CCCCCCCCCCCCCCCCCCCCCCCCC1
1C111111111111111111111111111111C1
1E11CCCCCCCCCCCCCCCCCCCCCCCCCCCCC1
1111C11111111111111111111111111111
1CCCCCCCCCCCCCCCCCCCCCCCCCCCCCCCC1
1C111111111111111111111111111111C1
1C111111CCCCCCC11CCCCCCC11CCCCCCC1
1C111111C11111C11C11111C11C1111111
1CCCCCCCC11111CCCC11111CCCC1111111
1111111111111111111111111111111111