111111111111111111111111111111111111
1P1C00000000000000000000000000C11111
101011111111111111111111111111010001
10101C0000000000000000000000C1010101
101010111111111111111111111101010101
10101C00000000000000000000E101010101
101011111111111111111111111101010101
101C000000000000000000000000C1000101
101111111111111111111111111111111101
1C0000000000000000000000000000C11101
111111111111111111111111111111000001
111111111111111111111111111111111111