11111111111111111111111111111111
1P1C00000000000000000000000000C1
10101111111111111111111111111101
10101C0000000000000000000000C101
10101011111111111111111111110101
10101C00000000000000000000E10101
10101111111111111111111111110101
101C000000000000000000000000C101
10111111111111111111111111111101
1C0000000000000000000000000000C1
11111111111111111111111111111111