11111111111111111111111111111111111111111111111111111111111111111111
11111111111000000000000000000000000P11111111111111111111111111111111
11111111111011111111111111111111111111111111111111111111111111111111
11111CCCCCCC11CCCCCCCC000C111111111CCCCCCCC11CC11111C00CCCCCCCC11111
11111C11111111C111111C111C111111111C111111C11CCC1111C11C111111011111
11111C11111111C111111C111C111111111C111111C11C1CC111C11C111111011111
11111CCCCCCC11C111111C111C111111111C111111C11C11CC11C11C11ECCCC11111
11111111111C11C111111C111C111111111C111111C11C111CC1C11C111111C11111
11111111111C11C111111C111C111111111C111111C11C1111CCC11C111111C11111
11111CCCCCCC11CCCCCCCC111CCCCCCCC11CCCCCCCC11C111111C11CCCCCCCC11111
11111011111111111011111111111111011111101111101111110110111111111111
11111000000000000000000000000000000000000000000000000000111111111111
11111111111111111111111111111111111111111111111111111111111111111111