1111111111111111111111111111111111111111111111111111111111
10000000000000000000000000000000000000000000000000000000P1
1011111110101111110101111111010111111011111111101111111101
1010000000100000010101111111010000001010000000101000000001
1010000000101111010101111111010111101010111110101000000001
1011111110101111010101111111010111101010111110101000111101
1000000010101111010101111111010111101010111110101000000101
1000000010100000010100000000010000001010111110101000000101
101111111011111111011111111101111111101011E110101111111101
100000000000000000000000000000000000000000C000000000000001
1111111111111111111111111111111111111111111111111111111111